OOOOXXXOOOOOOOO
OOOXOOOXOOOOOOO
OOXXOXOXOOOOOOO
OOXXOXXOOOOOOOO
OXXXOOOOOOOOOOO
XXXXXOOOOOOOOOO
XXXXXXXXXXXXXXO
OOXXXXXXXXXXXXX
OOXXXXXXXXXXXXX
OOOXXXXXXXXXXXX
OOOOXXXOOOOXXXX
OOOOOXOOOOOOXOX
OOOOOXOOOOOOXOO
OOOOOXOOOOOOXOO
OOOOXXOOOOOXXOO