OOOXXOOOOOXXOOO
OOXXOOOOOOOXXOO
OOXXOOOOOOOXXOO
OOXXOOOOOOOXXOO
OOOXXOOOOOXXOOO
OOOXXXOOOXXXOOO
OOOOXXOOOXXOOOO
XXOOOXXXXXOOOXX
OXXOXOOOOOXOXXO
OOXXXOOOOOXXXOO
OOOOXXXXXXXOOOO
XXXXXOOXOOXXXXX
OOOOXOOXOOXOOOO
OXXXXOOXOOXXXXO
XXOOXXXXXXXOOXX