OOOOXXXXXXOOOOO
OOOXXXXXXXXOOOO
OOOXXXOOXXXXOOO
OOOOOOOOOXXXXOO
OOOOOOOOOOXXXOO
OOOOOOOOOXXXXXO
OOOXOOOXOXXXOXX
OOOXOOOXOOOOOOX
OOXXXXXXXOOOOXX
OXXXXXXXXXOOOXO
OXXXOOOXXXOOOXO
OXXOOOOOXXOOXXO
XXXOOOOOXXXOXOO
XXXXOOOXXXXXXOO
XXXXXXXXXXXOOOO