OOOOOXXOXXOOOOO
OOOOXXXXXXXOOOO
OOOOXXXXXXXOOOO
OOOOXXXXXXXOOOO
OXXXOXXXXXOXXXO
XXXXXOXXXOXXXXX
XXXXXXOXOXXXXXX
OXXXXXXOXXXXXXO
XXXXXXOXOXXXXXX
XXXXXOOXOOXXXXX
OXXXOOOXOOOXXXO
OOOOOOXXOOOOOOO
OOOOOXXOOOOOOOO
OOXXXXOOOOOOOOO
OOXXOOOOOOOOOOO