XXXXOOOOOOOOXXXX
XXXOOOOOOOOOOXXX
XOOOOOOOOOOOOOXX
XOOOOOOOOOOOOOOX
OOOOOOOOOOOOOOOX
OOXXOOOOXXXOOOOO
OXXXXOOXXXXXOOOO
OXXXXOOXXXXXOOOO
OOXXOOOOXXXOOOOO
OOOOOXXOOOOOOOOX
XOOOOOXOOOOOOOXX
XXOOOOOOOOOOOXXX
XXOXOXOXOXOOXXXX
XXXXXXXXXXOOXXXX
XXXOXOXOXOOXXXXX
XXXOOOOOOOOXXXXX