OOOOOOOOOOOOXXXXXOOO
OOOOOOOOOOXXXXOOOOXX
OOOOOOOOXXXXOOOOOXXO
OOOOOOOXXXXOOOOOXXOO
OOOOOOXXXXOOOOOXXOOO
OOOOOXXXXXXOOOOXXOOO
OOOXXOXXXXXXOOXXOOOO
OOXXXXOXXXXXXOXXOOOO
OXXXXXOXXXXXXXXXOOOO
XXOXXXOXXXXXXXXXOOOO
XXXXXXOXXXXXXXXXOOOO
XXXXXXOXXXXXXXXXOOOO
OXXXXXOXXXXXXOXXOOOO
OOXXXOXXXXXXOOXXXOOO
OOOOXXXXXXXOOOOXXOOO
OOOOOOOXXXXOOOOOXXOO
OOOOOOOOXXXXOOOOOXXX
OOOOOOOOOXXXXOOOOOOO
OOOOOOOOOOXXXXOOOOOO
OOOOOOOOOOOOXXXXXOOO