OOOOOOOOOOOOXXOO
OOOOOOOOOOOXXOXO
OOOOOOOOXXXOXXOO
OOOOOOOXXXXXOOXO
OOOOOOXXXXXXXXXX
OOOOOXXXXXXXXXXX
OOOOOXXXXXOXXXXO
OOOOXXXXXXXOXOOO
OOOOXXXXOXXXOOOX
OOOOOXXXOOOXXXXO
OOXXXXXOOOOOOXOX
OXXOOOOOOOOOOXOO
XXOOOOOOOOOOOOOO
XXOOOOOOOOOOOOOO
XXOOOOOOOOOOOOOO
XXXOOOOOOOOOOOOO