OOXXOOOOOOOOOOOOOXX
OXXXXXOOOOOOOOOXXXX
XXXXXXXXXOOOOXXXXXO
XXXXXXXXXXXOXXOOXXO
OXXXXXXXXXXXXOOOXOO
OOOXXXXXXXXXOOOXXOO
OOOOOXXXXXXOOOXXOOO
OOOOOOOXXXXOOXXXOOO
OOOOOOOXXXXXXXXXXOO
OOOOOOXXXXXXXXXXXOO
XXXXOXXXXXXXXXXXXXO
XXXXXOXXXXXOXXXXXXO
OXXXOXXXXXOOOXXXXXO
OOOOXXXXOXOOOXXXXXX
OOOOXXXOXOOOOOXXXXX
OOOOXXOXXXOOOOXXXXX
OOOOOOOXXXOOOOOXXXX
OOOOOOOXXXOOOOOXXXO
OOOOOOOOXXOOOOOOXOO