OOOOOOOOXXXXXOOOOOO
OOOOOOXXXXXXXXOOOOO
OOOOOXXXOOXXXXXXXOO
OOOOXXXXOXXXXXXXXXO
OOOOXXXXXXXXXXXOOXO
OOOXXXXXXXXXOOOXXOO
OOXXXXXXXXXXXXXOOOO
OXXXXXOXXXXOOOXOOOO
OXXXXXOXXOOOOOXXXOO
XXXXXXOXXOOOOOOXXXO
XXOXOXXOXOOOOOOXXXO
OOOXXOXOXXOOOOXXXXX
OOOOXXOOXXXOOXXOOXX
OOOOXXXXXXXOOXOOOOO
OOOOOXXXXXXXOXOOOOO
OOOOOOOXXXXXXOOOOOO
OOOOOOOOOXXXXXXXXOO
OOOOOOOXXXXXXXXXXOO
OOOOOOOXXXXOOXXXOOO