XXOOXOOOOOOOOOOO
XXXOXOXOOOOOOOOO
OXXXXXXOOOOOOOOO
OOXOXOXOOOOOOOOO
XXXXOOXXXXXOOOOO
OOXOOXXXXXXXOOOO
OXXXXXOOXOOXXOOO
OOOOXXOXXOXXXXOO
OOOOXXXXXXXXXXXO
OOOOXXOOXOOXOOXX
OOOOXXOXXOXXOXXX
OOOOOXXXXXXXXXXX
OOOOOOXXXOOXOOXX
OOOOOOOXXOXXOXXO
OOOOOOOOXXXXXXOO
OOOOOOOOOXXXXOOO