OOOOXOOOOO
OOOOXOOOOO
OOOXXOXOOO
OOOXXOXOOO
OOXXXOXXOO
OXXXXOXXXO
XXXXXOXXXX
OOOOOXOOOO
OXXXXXXXXO
OOXXXXXXOO