OOOOOXOOOO
OOOXXXXXOO
OOOXXXXXOO
XXOXOXXXXX
OXOXXXXXOX
OXOXOXXXOX
OXXXOXXXOX
OXXXXXXXXX
OOOXXXXXOO
OOOXXXXXOO