OOXOOOOOOO
OXXOXOXOOO
XOXXXXXOOO
XOOOOOXXOO
XOOOXOXOXO
XXXOOOOOOX
OXOOOOOOOX
OOXXOOOOOX
OOXOOOXOOX
OOXOXOXXOX