OXXXXXXXOO
XXOOOOOXXO
XOOOOOOOXO
XXOXOOXXXX
OXXXOXXXOX
OXOXXXXXOX
OXXXXXOXOX
OXXOXXXXOX
OXXXXXXXXX
OXXXXXXXOO