OOOOXXXXXO
OOOOOOXOOO
OOOOOXXXOX
OOXXXXXXXX
OXXOOOOOOX
OXOOXXXXXX
OXOXOOOOOX
OXXXOOOOOO
OOXOOOOOOO
XXXXXXXXXX