OOOOOXXXXO
OOOOOXOOXO
OXOXXXXOXO
XXXXOOXXXX
XOOXXXXXOX
XXXXOOXXXX
XXXOXXOXXX
XXXOXXOXXX
XXXXOOXXXX
XXXXXXXXXX