XXOOXXXXOO
XXOXXOOXOO
XXXXXXXOOO
OOXXXXXXOO
XOXOOXXXOO
XXXOXXXOOX
OOOOXOXXXX
OOOOXOOOXX
OOOXXOOOOX
OXXXXXOOOO