OOOOOXXXXO
OOOOXXXOOO
OOXXXXXOOO
OXXXXXXXOX
OXOXXXXXXX
XXOXOXXXXX
XXXXOXXXXX
OXXOXXXXOX
OOXXXXOOOX
OOOOXXXXOO