XOOXOOOOOO
XXXXOOOOOO
OXOXOOOOXX
XXXXOOOOXO
XXXXXXOOXO
OXXXXXXOXO
OXXXXXXOXO
OXXXXXXOXO
OXXXXXXOXO
OXXXXXXXXO