OOOOOXXXXX
OOOOXXXXXO
OOOXXXOOOO
OXXOOOXXXX
OXXOXOXOOX
XXXXXXXOOX
XXXXXXXXXX
XXXXXXXXXX
XXXXXXXXXX
OXXXOOXXXO