OOOOOOOOXO
OOOOOOOXOO
XXXXXXXXXX
XXOOOOXOXX
OXXOOXOXXO
OOXXXXXXOO
OOOOXXOOOO
OOOOXXOOOO
OOOOXXOOOO
OOOXXXXOOO