OOOXXXXOOO
OOXXOOXXOO
OXOOOOOOXO
XOOXOOXOOX
XOOOOOOOOX
XXXXXXXXXX
OOXOXOXOXO
OXOOXOOXOX
OXOXOOOXOX
XXOXOOOXOX